10 10
C,  8,  8,  8,  8,  8,  8,  8,  8,  9
4,  0,  0,  0,  0,  0,  0,  0,  0,  1
4,  0,  0,  0,  0,  0,  0,  0,  0,  1
4,  0,  0,  0,  0,  0,  1,  0,  0,  1
4,  0,  0,  0,  0,  0,  1,  0,  0,  1
4,  0,  0,  0M1,  0,  0,  0,  0,  0,  1
4,  0,  0,  0I,  0,  0,  0,  0,  0,  1
4,  0,  0,  0,  0,  0,  0,  0,  0,  1
4,  0,  0,  0,  0,  0,  0,  0,  0,  1
6,  2,  2,  2,  2,  2,  2,  2,  2,  3
