6 6
C,  8,  8,  8,  8,  9
4,  0,  0,  0,  0,  1
4,  0,  0,  0,  0,  1
4,  0,  0,  0,  0,  1
4,  0,  0,  0,  0,  1
6,  2,  2,  2,  2,  3
